// Used to edit brightness of your screen manually
alias bn='nano /sys/class/backlight/amdgpu_bl0/brightness'

alias update= 'sudo apt update'

alias upgrade= 'sudo apt update && sudo apt full-upgrade'

alias ll='ls -lh'

alias la='ls -lha'

alias l='ls -CF'

alias em='emacs -nw'

alias dd='dd status=progress'

alias _='sudo'

alias _i='sudo -i'

alias please='sudo'

alias fucking='sudo'

alias ls='ls --color=auto'

alias dir='dir --color=auto'

alias vdir='vdir --color=auto'

alias grep='grep --color=auto'

alias fgrep='fgrep --color=auto'

alias egrep='egrep --color=auto'

alias instal='sudo apt install'

alias mv='mv -i'

alias cd1='cd ..'

alias cd2='cd ../../'

alias cd3='cd ../../../'

alias gs='git status'

alias gd='git diff'

alias gc='git clone'

alias gco='git checkout'

alias gb='git branch'

alias gp='git push'

alias gca='git commit --amend'

alias gl1='git log --oneline'

alias gr='git remote -v'

alias gra='git remote add'

alias gf='git fetch'

alias gcp='git cherry-pick'

alias gcpc='git cherry-pick --continue'

alias gcpa='git cherry-pick --abort'

alias gmc='git merge --continue'

alias gma='git merge --abort'

alias grbi='git rebase -i'

alias grbc='git rebase --continue'
